tongan	english
ha	a/an, ability
able lava	ability
malava	1. be able to
talēniti’ia	2. talented, Aboriginal person
about tokotaha ‘Apo	Aboriginal person
meimei	1. approximately, 2. concerning
above fekau’aki	2. concerning
‘i ‘olunga	1. over
hangē ko ia ‘i ‘olunga	2. the example above
li’aki	absent
mātu’aki	absolutely
fakamamafa	accent
tali	accept
ala tali	acceptable
fakatu’utāmaki	accident
matu’utāmaki	accidental
fakafe’ao	accompany
tohi mo’ua	account
langa	ache
lava’i	achieve
tou’anga	achievement
fakalava/fehauaki	across
ngāue	act
va’inga	activity
tangata faiva	actor
tānaki	add
fakalahi/fika tānaki	addition
tu’asila	address, adjective
admit hoānauna	adjective
tala ko e mo’oni	1. tell the truth about
fakahū	2. allow to enter
ngāue’aki	adopt (take on)
tokotaha lahi	adult
faingamālie’anga	advantage
me’a fakaofo ‘oku hoko	adventure
hoāveape	adverb
akonaki	advice
fakamalohisino	aerobics
vakapuna	aeroplane
lava hono totongi	afford
ilifia	afraid
kimui	after
ho’atā	afternoon
kimui	afterwards, again (one more time)
against toe ‘ai	again (one more time)
fa’aki ki	1. next to
fakafepaki	2. anti
ta’u	age
kuo hili	ago, agree
aid loto taha	agree
tokoni	1. help
tokoni’i	2. help
taumu’a	aim (try)
‘ea	air
mala’e vakapuna	airport
kātoa	all (every)
fakangofua	allow
tokotaha	alone
le’o lahi	aloud
motu’alea	alphabet
‘osi	already
pea mo	also (too)
neongo	although
kotoa pe	altogether, always
am *see be ma’u ai pe	always
me’alele uta mahaki	ambulance
hono lahi	amount
manu tahi mo ‘uta	amphibian
‘analaiso	analyse (study)
pea	and
tuliki	angle (mathematical usage)
‘ita	angry
manu	animal
tunga’iva’e	ankle, annual
answer fakata’u	annual
tali	1. reply
tali	2. reply
noa pē	any
ha toe	anymore
ha taha pe	anyone
ha me’a pe	anything
fakamavahe	apart (separate)
fakamolemole	apology
fotu mai	appear (come into view)
‘apele	apple, appointment
are *see be fokotu’u	appointment
‘elia	area
fakakikihi	argue
kē	argument
tu’u	arise
uma	arm (part of body)
kau tau	army, around
arrange takatakai	around
fakahokohoko	1. put in order
fokotu’utu’u	2. make plans
puke	arrest (take into custody)
tau mai	arrive
ngahau	arrow
tā fakatātā	art
tokotaha tā fakatātā	artist
hangē	as (to such a degree)
efuefu	ash
mā	ashamed
kole	ask
fakatahataha	assemble
fakataha	assembly
homueka	assignment (for school)
tokoni	assist
tokotaha tokoni	assistant, at
ate *see eat athletics ‘i he	at
kātoanga sīpoti	athletics carnival
‘atomi	atom, attach
attack fakapipiki	attach
lapasi	1. fight, 2. fight
attempt ‘ohofi/fuhu	2. fight
‘ahi’ahi	1. try
feinga	2. try
‘alu ki	attend
tokolahi	attendance
tokanga	attention
feinga fakatokanga’i	attract
fakamānako	attractive, aunt
Aussie *see Australian mehikitanga/fa’e	aunt
‘Aositelelia	Australia
tokotaha ‘Aositelelia	Australian
fuka ‘Aositelelia	Australian flag
to’onga ‘Aositelelia	Australiana
tokotaha fa’u tohi	author
faha’ita’u mokomoko	autumn, average
‘avalisi	1. arithmetical mean
anganoa	2. ordinary
faka’ehi’ehi	avoid
‘a	awake
mama’o	away
mama’o mei he	away from, awful
awoke *see awake faka’ulia	awful
toki	axe
pēpē	baby back
tu’a	1. body part
mui	2. opposite front
fakafoki	3. give it back
hui tu’a	backbone
hā mei mui	background
kato kaveitu’a	backpack
toumui	backyard
kovi	bad
petiminitoni	badminton
kato	bag
ta’o	bake
palanisi	balance
fakafaletolo	balcony, bald
ball tula	bald
pulu	1. toy
fiefia	2. have a ball (good time)
pula	balloon
siaine	banana
tāme’a	band (music group)
vesa	bangle, bank
bar pangikē	bank
pa	1. place to drink
ta’ofi	2. stop from something
me’a ta’ofi	3. metal rod, barbecue
barbie *see barbecue papakiu	barbecue
tekefua	bare
fakangatangata’anga	barrier
tu’unga	base (bottom)
pesoni	basin (wash)
kato	basket
pasiketipolo	basketball, basketball court
bat mala’e pasiketipolo	basketball court
pate va’inga	1. sporting equipment
peka	2. animal
kaukau	bath
falekaukau	bathroom
tau	battle, bay (inlet)
BBQ *see barbecue pei	bay (inlet)
‘i ai	be
tahi	beach
taueli kaukau tahi	beach towel
fakamalu	beach umbrella, beak
beam ngutu	beak
huelo	1. ray of light
pimi	2. wooden plank
piini	bean, beard
beat kava	beard
mālohi	1. win
tā	2. hit
ongo	3. rhythm, beautiful
became *see become faka’ofo’ofa	beautiful
koe’uhi	because
hoko	become
mohe’anga	bed
loki mohe	bedroom
pī	bee, beef
began *see begin pulu	beef
kamata	begin
tokotaha kamata	beginner
tō’onga fai	behave
tō’onga	behaviour
ki mui	behind
fafangu	bell
kau	belong
leta	belt
tēpile lōloa	bench, bend
bent *see bend piko’i	bend
lelei taha	best
peti	bet
sai ange	better
vaha’a	between
pasikala	bicycle
tuki	bid
big – boat	
lahi	big
1. money	n, la’i pa’anga
tohi mo’ua	2. account
3. of a bird	n
manupuna	bird, birth
fanau	1. act of being born
2. date of birth	phrase, ‘aho fā’ele’i
‘aho fā’ele’i	birthday
biscuit	n
bit	pisikete
ki’i konga	1. small piece
2. a little bit	phrase
pt v	konga si’i
u’u	bite
black (colour)	adj
palakipoe	blackboard
mata’i tele	blade
tukuaki	1. censure
tukuaki’i	2. lay responsibility with
blank	adj
kafu	blanket
tafe toto	bleed
blew *see blow blind	pt v
1. unable to see	adj, kui
puipui	2. window covering
blindness	n
block	anga kui
poloka	1. child's toy
2. stop from doing something	v
phrase	ta’ofi
poloka	3. a block away
‘otu poloka feleti	4. block of flats
blond	adj
toto	blood
toto’ia	bloody
tā	1. hit
puhi	2. pertaining to wind
3. blow up	phr v
blue	pā
pulū	1. colour
2. sad	colloq
lau papa	board (stiff material)
veimau	board game
boat	n, vaka, body boil
bold sino fakalili	body boil
faka’ilonga mamafa	1. as typeface
lotolahi	2. daring
pomu	bomb
hui	bone
tohi	book
tuku’anga tohi	bookshelf, boomerang
boot pūmalengi	boomerang
puti	1. of car, 2. footwear
border puti	2. footwear
tapafonua	1. as of country, state
ngata’anga	2. edge
fakapipiko	bored
fakapiko	boring, borrow
boss nō	borrow
tokotaha pule	1. person in charge
pule’i	2. tell what to do
fakatou’osi	both
fakahoha’asi	bother, bottle
bottom hina	bottle
tu’ungaiku	1. body part, 2. lower edge
bought *see buy takele	2. lower edge
fakapuna	bounce
poulu	bowl
puha	box, boy
bra *see brassiere tamasi’i	boy, brain
branch ‘uto/’atamai	brain
va’akau	1. of tree
fakamavahe’i	2. separate
pōtisi	brassiere
to’a	brave
fakato’a	bravely
mā	bread, breadth
break ma’ukupu	breadth
mālōlō	1. pause
maumau’i	2. opposite of fix
maumau	3. break down (as in car)
puke	4. break down (as health)
haefale	5. break in (as housebreak)
tutuku	6. break up (for holidays)
kaipongipongi	breakfast
mānava	breath
mānava	breathe
fakafanau	breed
piliki	brick, bridge
bright hala fakakavakava	bridge
ngingila	1. shiny
poto	2. clever
fakangingila	brighten
fetapaki	brilliant
‘omai	bring
fālahi	broad, broccoli
broke *see break polokolī	broccoli
hala’atā	broke (penniless)
nima lavea	broken arm, brother
brought *see bring tuōnga’ane	brother
polosi	brush
kane	bucket, build
built *see build langa	build
maama	bulb (electric light), bullet
bully pulukōkō	bullet
tokotaha houtamaki	1. person who harasses others, 2. harass
bunch fakaaoao	2. harass
pupunga	1. group, 2. bunch of flowers
burn ha’inga	2. bunch of flowers
vela	1. injury caused by fire
vela	2. be on fire
pā	burst
tanu	bury, bus
bush pasi	bus
vao	1. outback, 2. small tree
business vao/oloolo	2. small tree
kautaha	1. company
tuku ho’o kaunoa	2. mind your own business
tau’anga pasi	bus stop, bust
maumau’i	1. break
2. female body part	n
adj	fo’i huhu
mo’ua	busy
kaekehe	but
butcher	n
fakama’u	button
fakatau	buy
by	prep
C	‘i, ‘e
kāpisi	cabbage
cable	n
falekai	cafe
finaki	cage
cake	n
v	keke
fakafuofua	calculate
misini tānaki	calculator
calendar	n
call	tohi māhina
ui hingoa	1. name
2. as for phone	n
phr v	telefoni
ui ki he	3. call for
ta’ofi	4. call off
5. call out	phr v
calm	kaila
nonga	1. peaceful
2. calm down	phr v
pt v	fiemālie
me’afaitā	camera
camp	v
can	kemi
malava	1. able to
2. steel container	n
te’elango	candle
kenitini	canteen (tuck shop)
kepi	1. headwear
tāpuni	2. top
kolomu’a	1. important location
mata’itohi lahi	2. capital letter
capsicum	n
me’a fa’o’anga	capsule
kapiteni	captain
car	n
kaati	card
kaati pooti	cardboard
care	v, tokanga
fakaalaala	careful
fai tokanga	carefully
kanivolo	carnival, carrot
carry kāloti	carrot
‘ave	1. take, 2. carry on (keep going)
case hokohoko atu	2. carry on (keep going)
kato	1. bag
telia na’a	2. just in case, cash
cassette pa’anga	cash
tepi kāsete	1. audio cassette, 2. video cassette
cast kāsete vitio	2. video cassette
kau faiva	1. of a play
tolo	2. throw
kāsolo	castle
fāinoa	casual, cat
catch pusi	cat
tali lēlue	1. catch a train
fofonu	2. catch a cold
mahino	3. catch on (understand), 4. catch up (reach)
caught *see catch a’u	4. catch up (reach)
‘uhinga	1. reason
fakahoko	2. make happen, cave
CD *see compact disc ‘ana	cave
‘aofi	ceiling
loki si’i	cell
seniti	cent, central
central processing unit lotomālie/lotoloto	central
misini fakakomipiuta	1. pertaining to computer, 2. CPU
lotomālie	centre
senituli	century
me’akai pongipongi	cereal
kātoanga	ceremony
pau	certain
fakapapau	certainly
seini (siueli)	chain (jewellery)
sea	chair
sioka	chalk
chance – cigarette	
faingamālie	chance
fetongi	1. money
liliu	2. alter
3. change one's mind	phrase
phrase	liliu ‘eku fakakaukau
fetongi vala	4. change clothes
feliliuaki	changeable
change room	n
senolo	channel
vahe	chapter
character (literary)	n
charge	tokotaha ‘i he tohitalanoa
totongi	1. cost
2. as for battery	v
phr v	fakafonu
pule	3. in charge
tuli	chase
cheap	adj
v	ma’ama’a
kākā	cheat
sivi	check
cheek (body part)	n
colloq	kou’ahe
pau’u	cheeky (naughty), cheer
fakafiefia’i	1. make happy
2. sound expressing enthusiasm	n, ongo fiefia
kemisi	chemist
cheque	n
seli	cherry
veimau	chess
chest	n
pululole	chewing gum, chicken
moa	1. animal
2. not brave	colloq, loto fo’i
leka	child
childish	adj
kumukumu	chin, chips
pateta fakapaku	1. hot variety
2. cold crisps	n, pateta chips
sokoleti	chocolate
choir	n
v	kau hiva
fili	choose, chop
konga kanomate	1. meat cut
2. cut	v, hifi
falelotu	church
cigarette	n, sikaleti
falefaiva	cinema
siakale	circle
fuopotopoto	circular
takatakai	circumference, city
claim kolo	city
‘eke	1. assertion, 2. assert
clap ‘eke’i	2. assert
le’olahi	1. loud noise
pasipasi	2. show appreciation
kalasi	class (group of students)
kaungā ako	classmate
loki ako	classroom
poloka lokiako	classroom block
pesipesi	claw, clay
clean kelepulu	clay
fakama’a	1. remove dirt
ma’a	2. opposite dirty
faka’atā	clear
poto	clever
lilifa	cliff
kaka	climb
piki	cling, clock
close uasi	clock
tāpuni	1. shut
ofi	2. near
tāpuni’i	closed
tupenu	cloth
vala	clothes
uaea taufō	clothes line
vala	clothing
‘ao	cloud, cloudy
club ‘ao’aofia	cloudy
kautaha	1. group of people
pōvai	2. implement
‘ilo’anga	clue
malala	coal
matāfonua	coast
matafonua	coastal
kote	coat
kokī	cockatoo
niu	coconut
kofi	coffee
koini	coin, cold
fofonu	1. illness
momoko	2. opposite hot
anga momoko	cold-blooded
kola	collar
tānaki	collect
tānekinga	collection, college
colour kolisi	college
lanu	1. hue
fakalanu	2. make colourful, colourful
comb fakalanulanu	colourful
helu	1. hair accessory, 2. do one’s hair
come helu	2. do one’s hair
ha’u	1. move towards
ha’u mei	2. come from
hopo	3. come out (as in sun)
Tau ō!	4. Come on! (Let’s go.)
fiemālie	comfortable
kōmiki	comic
konga kōmiki	comic strip
fekau	command
noa	common
fakapotopoto	commonsense
fetu’utaki	communication
kakai ‘o e kolo	community
CD	compact disc
kautaha	company (business)
fakatatau	compare
kāpasa	compass
‘u kāpasa	compasses (geometry, equipment)
fe’auhi	compete
fe’auhi	competition
lāunga	complain, complaint
complete lāunga	complaint
‘osi	1. finish
‘osi	2. finished
fakafihi	complicate
fihi	complicated
faingata’a	complication
punake	composer
fa’u	composition
komipiuta	computer
me’a	concern
kau	concerned
concert	n
tu’unga	condition
kouni	cone (geometrical shape)
confuse	v
v	veuki
fakamālō’ia	congratulate
fakahoko	connect
connection	n
adj	fehokotaki
‘a/’ilo	conscious
fakakaukau	consider
consist of	phr v
konisinanite	consonant
fa’o	contain
container	n
hokohoko	contents (as of a book)
hoko atu	continue
faikehekehe	1. difference
fakahā e faikehekehe	2. find differences
control	v
fetalanoa’aki	conversation, convict
fakahalaia’i	1. person convicted of a crime
2. find guilty of a crime	v, halaia
kuki	cook
adj	cool
mokomoko	1. opposite warm
tōatu	2. trendy
fakatatau	1. imitation
fakatatau	2. imitate
corner	n
correct	tuliki
fakatonutonu	1. make right
2. right	adj
vaha’a holo	corridor
totongi	cost
cotton	n
vavae	cotton wool, cough
tae	1. the act or sound of coughing
2. expel air from the lungs	v, tae
kōsilio	council
counsellor	n
country	konisela
fonua	1. political division
2. opposite city	n
ongome’a	couple
loto to’a	courage
courageous	adj, loto to’a
course	loto to’a
koosi	1. set of lessons
2. way to go	n, ‘alu ‘anga
ko ia	3. of course (naturally)
court (as tennis court)	n
tokoua	cousin, cover
takafi	1. outside of a book
2. put cover on something	v, ‘ufi’ufi
vaipalo	coward
crab	n
v	paka
masisi	crack, craft
vaka	1. vessel
2. handiwork	n, faiva
crash	faiva
fepaki	1. collision
2. shatter	v, hinga
fakasesele	crazy
creature	n
vaitafe si’i	creek
totolo	creep
crescent (shape)	n
cricket	kalipa
kālihi	1. insect
2. sport	n
criminal	kilikiti
tangata hia	1. person who commits crime
2. against the law	adj
kolokataile	crocodile
pikopiko	crooked
crops	n
cross	to’u ta’u
kolosi	1. a symbol of two
adj	intersecting lines
‘ita	2. angry
kolosi	3. move from one side to another
4. cross out (delete)	phr v
va’inga fakafo’ilea	crossword
fu’u kakai	crowd
crowded	adj
adj	fe’efi’efihi/mumu
anga fakamamahi	cruel, crush
ta’omi	1. flatten
2. a liking for someone	colloq, fakatokanga
cry	fakatokanga
tangi	1. loud utterance
tangi	2. weep
kiupi	cube
kiukamipa	cucumber
kōpate	cupboard
fakamo’ui/faito’o	cure, curious
curl fie’ilo	curious
mingimingi’i lou’ulu	1. ringlet of hair
fakamingimingi	2. form curls, currency (money)
current pa’anga	currency (money)
talopiki	1. topical
‘au	2. moving water
puipui	curtain
ngaofe’anga	curve
anga	custom
kasitomā	customer
hifi	cut, cute
cycle angapoto	cute
‘aka	1. ride
takai	2. circular event
me’a fuopotopoto	cylinder, daily
damage faka’aho	daily
lavea	1. injury
fakalavea	2. cause injury
nga’unga’u	damp, damper (type of bread)
dance mā	damper (type of bread)
hulohula	1. social gathering for dancing
haka	2. rhythmical movement
fakatu’utāmaki	danger
fakatu’utāmaki	dangerous, daring
dark anga fiepole	daring
po’uli	1. opposite light
‘uli’uli	2. opposite fair
fakapo’uli	darkness, date
‘aho	1. calendar
teiti	2. fruit
‘ofefine	daughter
‘aho	day
mate	dead, deaf
deal tuli	deaf
lahi	1. amount
tufa	2. give out
mate	death, debt
decay mo’ua	debt
pala	1. decomposition
‘aunga	2. rot
lohiaki’i	deceive
fakapapau	decide
tesimale	decimal
tu’utu’uni	decision
tu’unga	deck (of house), declare
decrease tala/fakahā	declare
si’isi’i	1. diminution
fakasi’isi’i	2. become smaller in number, deep
defeat loloto	deep
mole	1. loss
fo’i	2. beat, define
degree faka’uhinga	define
tikili	1. of temperature, 2. amount
delay tu’unga	2. amount
tu’u	1. hold up, 2. put off till later
deli *see delicatessen ta’ofi	2. put off till later
teli	delicatessen
fiefia	delight
fakafiefia	delightful, deliver
demand tufa	deliver
fekau	1. urgent requirement
tu’utu’uni	2. ask for with authority
fakahāa’i	demonstrate
fakahā	demonstration
tōketā nifo	dentist
fakafalala	depend
falala’anga	dependable
falala	dependant
loloto	depth
hifo	descend
fakamatala	describe, description
desert fakamatala	description
lala	1. hot, dry place
li’aki	2. leave, deserve
desire taau	deserve
manako	1. longing
‘unaloto	2. wish for
tēpile	desk
faka’auha	destroy, destruction
detail ‘auha	destruction
mingimingi’i me’a	1. minute part
fakamatala fakaikiiki	2. describe fully
tokotaha fakatotolo	detective
ngāue mo’ua	detention (pertaining to, school)
taila	dial, diameter
diamond taiamita	diameter
taiamoni	1. precious stone
taiamoni	2. shape
tohi noa	diary, dictionary
did *see do tikisinale	dictionary
didgeridoo	didgeridoo
mate	die
me’akai fakafuofua	diet
kehe	different
faingata’a	difficult
keli	dig
tingikou	dingo
kai efiafi	dinner
tainasoa	dinosaur
feitu’u	direction
‘uli	dirt
likoliko	dirty
ta’eloto	disagree
loto kehekehe	disagreement
tupe	disc (round, flat object)
tisikou	disco
‘ilo	discover
ma’u fo’ou	discovery
alea’i	discuss
fealea’aki	discussion
disease – drop	
mahaki	disease
tisi	dish
misini fufulu ipu	dishwasher (appliance)
tisi	disk (of computers)
tisi ’i he komipiuta	disk drive
fehi’a	dislike
tukuange	dismiss
mama’o	distance
fakahoha’asi	disturb
uku	dive
vahevahe	divide
vahe	division, divorce
do vete	divorce
fai	1. perform
Ko e hā ‘ene ngāue ‘oku fai´?	2. What does she do?
(what's her job?)	
‘Oku ke fēfē hake?	3. How do you do? (greeting)
tōketā	doctor
tohi fakamo’oni	document
kulī	dog
tola	dollar
matapā	door, double
doubt peluua	double
veiveiua	1. uncertainty
tāla’a	2. hesitate to believe
toho	drag, dragon
drank *see drink talākoni	dragon
tā fakatātā/valivali	draw, drawer
dream toloa	drawer
misi	1. images during sleep, 2. imagine
dreamt *see dream faka’ānaua	2. imagine
kofu	1. woman's clothing, 2. to put on clothing
drew *see draw vala	2. to put on clothing
inu	1. beverage
folo	2. swallow liquid
faka’uli	drive, driveway
drop halanga me’alele	driveway
to’i	1. small amount of water
fakatooki	2. let fall
drought – email	drought
drove *see drive la’ala’ā	drought
melemo	drown
faito’o konatapu	drug
nafa	drum
konā	drunk (person who drinks, too much alcohol), dry
dug *see dig mōmoa	dry
noa	dumb, during
dust lolotonga	during
efu	1. dirt
holo efu	2. clean of dirt
tupenu holoefu	duster
fatongia	duty (something you must do)
‘ikale	eagle
telinga	ear
mu’aki	early
ma’u mai	earn
hau	earring
kelekele	earth
hahake	east
faingofua	easy
kai	eat
‘ekina	echidna
tapa	edge
‘etita’i	edit
ako	education
lave’i	effect
feinga	effort
fo’imoa	egg
pe	either
fano	elastic, elbow
elder tui’inima	elbow
motu’a ange	1. older than
motu’a	2. older person
fili	election
tokotaha ngāue faka’uhila	electrician, electricity
email ‘uhila	electricity
tohi fakainitaneti	1. Internet letter
li ‘i he ‘initaneti	2. send an Internet letter
fakamā	embarrass
mā	embarrassed
fakafokifā	emergency
hiki fonua	emigrant
ongo	emotion
fakangāue’i	employ
ngāue totongi ki ha taha	employee
ngāue totongi ki ai ha taha	employer
ngāue	employment
maha	empty
‘īmiu	emu, encourage
end fakalototo’a’i	encourage
ngata’anga	1. termination
faka’osi	2. finish, enemy
engaged fili	enemy
mo’ua	1. busy
fakama’u	2. soon to be married
mīsini	engine
fiefia	enjoy
faka’ulia	enormous
fe’unga	enough
fakafehu’i	enquire
hū	enter
fakafiefia’i	entertain
pō faiva	entertainment
hū’anga	entrance
hū	entry
sila	envelope
‘atakai	environment
tatau	equal
‘ikueta	equator, equipment
escape naunau	equipment
hola	1. an act of escaping
hola	2. get away
faihoa	even (divisible by two)
efiafi	evening
me’a ‘oku hoko	event, every
exam *see examination kotoa	every, examination
example sivi	examination
fakatātā	1. illustration, 2. e.g.
lelei ‘aupito	excellent, exchange
fetongi	1. act of exchanging
fetongi’aki	2. give up for an equivalent
ue’i ke fiefia	excite
loto fiefia	excited
fiefia	excitement
fakalotofieifa	exciting, excursion
excuse ‘eva	excursion
fakafifihi	1. justification
kātaki	2. pardon
3. Excuse me!	int
Tulou!	exercise
fakamālohisino	1. physical work
homueka	2. class work, 3. exercise book
exit tohi ako	3. exercise book
hū’anga	1. way out
hū ki tu’a	2. go out
‘amanaki	expect, expensive
experience mamafa	expensive
hokosia	1. thing undergone, 2. undergo
experiment ongo’i	2. undergo
fakatotolo	1. science trial
‘ahi’ahi	2. try something
fakamatala	explain
fakamatala	explanation
fakapā	explode, explore
express fakatotolo	explore
fakavave	1. fast, 2. say
expression tala	2. say
sio ‘a hono mata	1. on face
kupu’i lea	2. in words
fakalahi	extra
mata	eye
kemo	eyebrow, face
mata	1. part of body
hanga ki mu’a	2. face the front
Tokanga’i me’a	3. Face it! (believe it)
mo’oni	fact
fale ngaohi’anga koloa	factory, fade fail
faint mae tō	fade fail
tea	1. not dark, 2. become unconscious
fair pongia	2. become unconscious
totonu	1. just
ulo	2. light
meimei	fairly (quite)
angelo	fairy
tō	fall
loi	FALSE, familiar
family maheni	familiar
fāmili	1. kin
tohi hohoko	2. family tree, famous
fan ongoongoa	famous
tokotaha tokanga kiate kita	1. great admirer
ī	2. equipment to blow air
mama’o	far
totongi	fare (cost for trip)
faama	farm
ākenga	fashion, fashionable
fast fe’unga mo e ākenga	fashionable
vave	1. quick
vave	2. forward in time
‘aukai	3. go without food
fakama’u	fasten
sino	fat
tamai	father
mele	fault
‘ofa	favour
manako’anga	favourite, fax
fear fax	fax
ilifia	1. feeling of impending danger
manavahē	2. be afraid
fulufulu’i manu	feather, feed
feel fafanga	feed
ongo’i	1. as emotion, 2. touch
fell *see fall alasi	2. touch
fefine	female (of gender)
‘ā	fence
fokotu’unga/vaka-fokotu’u	ferry
kātoanga	festival
mofi	fever, few
field si’i	few
mala’e	1. where sport is played
konga fonua lahi	2. open land, fierce
fight anga fīta’a	fierce
tau	1. battle, 2. engage in battle
figure fuhu	2. engage in battle
fika	1. number
tokotaha	2. person
fika’i	3. figure out (understand)
fakafonu	fill
filimi	film
faka’osi	final, find
fine kumi	find
‘afua	1. not raining
manifi	2. opposite thick
longomo’ui	3. well (healthy), finger
finish tuhu	finger
faka’osi	1. end point, 2. end
fire ‘osi	2. end
tuli	1. cease to employ
fana’i	2. shoot
afi	3. something burning
fana’one	fireworks
‘uluaki	first, first aid
fish ‘uluaki tokoni	first aid
ika	1. water creature
taumāta’u	2. catch fish, fishing rod
fit me’a taumāta’u	fishing rod
mo’ui lelei	1. healthy
hao	2. size
fe’unga lelei	3. fit in with (match well)
ngaohi	fix
fuka	flag
ulo	flame
tapa	flash (bright light)
tapa	flashing, flat
feleti	1. dwelling
fōlinga	2. shape, flavour
flew *see fly ifo	flavour
hola	flight
tētē	float, flood
floor tāfea	flood
faliki	1. part of a room
fungavaka	2. level of a building
tisi komipiuta	floppy disk
tafe	flow, flower
flu *see influenza matala’i’akau	flower
lango	1. insect
puna	2. move through the air
kakapu	fog (weather condition)
kakapu	foggy
pelu	fold
takafi	folder
muimui	follow
mata’i tohi	font
me’akai	food
vale	fool
vale	foolish
va’e	foot
‘akapulu	football, footwear
for sū	footwear
ma’atautolu	1. for us
ma’a NSW	2. for NSW, 3. for $5
force ‘aki e pa’anga ‘e 5	3. for $5
ivi	1. strength
fakamālohi	2. impose on
muli	foreign (not native)
tokotaha muli	foreigner, forest
forgave *see forgive vaotā	forest
fakangalo’i	forget, forgive
forgot *see forget fakamolemole	forgive, fork
form huhu	fork
foomu	1. paper you fill in
fa’u	2. make
fōlinga	3. shape
fakauikeua	fortnight
monū’ia	fortunate, fortunately
fortune monū	fortunately
koloa lahi	1. large amount of money, 2. luck
fought *see fight laki	2. luck
fauniteni	fountain
falakiseni	fraction, frame
free faka’esia	frame
ta’etotongi	1. costing nothing
‘atā	2. unoccupied
tukuange	3. let go
tau’atāina	freedom
momoko ‘o fefeka	freeze
‘aisi	freezer (appliance)
tu’o lahi	frequent, fresh
fridge *see refrigerator fo’ou	fresh
kaume’a	friend
fakakaume’a	friendly
ilifia	fright, frighten
from fakailifia’i	frighten
mei Senē	1. from Sydney
mei he’eku kui	2. from my grandmother, 3. from $10
front mei he pa’anga ‘e 10	3. from $10
mu’a	1. opposite back
‘i mu’a	2. in front of
matapā mu’a	front door
sitepu mu’a	front steps, frown
froze *see freeze fingo	frown, fruit
full fua’i’akau	fruit
fonu	1. opposite empty
mākona	2. not hungry, full stop (punctuation mark)
fun piliote	full stop (punctuation mark)
fakavā	1. mirthful amusement
fakakata’i	2. make fun of (ridicule)
putu	funeral, funny
fakaoli	1. humorous
faikehe	2. strange
fulufulu’i manu	fur
naunau fale	furniture
mama’o ange	further
kaha’u	future
pelepa’anga	gamble, game
gaol *see jail va’inga	game
ava	gap
tau’anga kā	garage (of house)
ngoue	garden
kāliki	garlic
kasa	gas
matapā	gate, gather
gave *see give tānaki	gather
fiefia	1. happy
kei	2. homosexual, gender
general hoto fefine/tangata	gender
lukufua	1. usual
seniale	2. rank in army
fakalukufua	generally
anga fie foaki	generosity
nima homo	generous, gentle
get anga fakaalaala	gentle
fakaa’u	1. become
ma’u	2. receive
ma’u	3. possess
a’u	4. arrive
ma’u	5. obtain
felātani	6. get on with (like)
‘alu	7. get out (leave)
fakataha	8. get together (meet)
tu’u hake	9. get up (arise), 10. get rid of (dispose of)
giant li’aki	10. get rid of (dispose of)
saianiti	1. huge mythical being
lahi ‘aupito	2. very big
me’a’ofa	gift
ta’ahine	girl, give
‘oange	1. hand to
fakahū	2. give in (hand in)
fakavaivai	3. give in (surrender)
tufaki	4. give out (distribute)
fakavaivai	5. give up (surrender)
tuku	6. give up (stop as for smoking), glad
glass fiefia	glad
matapā sio’ata	1. window material
ipu	2. drinking vessel
matasio’ata	glasses (for eyesight), glove
go kofunima	glove
‘alu	1. move
‘alu pasi	2. go by bus
‘alu mo	3. go out with
fehalaaki	4. go wrong
hokoatu	5. go on with (continue)
hoko lelei	6. go well
fakatonutonu	7. go over (check)
‘a’ahi	8. go through (check)
tulimui	9. go after (chase)
‘otua	god
koula	gold, golden
good koula	golden
lelei	1. opposite bad
‘oku sai ‘a e vesitapolo kia koe	2. vegetables are good for you
Lelei ‘aupito	3. Good for you! (congratulations)
4. Good afternoon (greeting)	int
5. Goodbye	int
6. Good day (greeting)	int
7. Good morning (greeting)	int
8. Good night (farewell)	int
Mohe ā	goodness
lelei	1. virtue
2. My goodness! (expression	int, of surprise)
koloa	goods, gossip
got *see get lau	gossip
pule’i	govern
pule’anga	government
kōvana	governor
puke	grab
māmālie	gradually
tenga	grain
lahi	grand
grandchild	n
mokopuna	granddaughter
kui	grandfather
grandmother	n
kui	grandparent
mokopuna	grandson
grape	n
kalafi	graph
musie	grass
grateful	adj
mala’e	grave
lahi/ongoongoa	great
greed	n
adj	mānumanu
mānumanu	greedy
lanumata	green
greet	v
talamonū	greeting
hinā	grey
grief	n, tengihia
fakalotomamahi	grieve
grill (cooking)	v
gross	tunu
fakakātoa	1. total
2. disgusting	colloq
ground	palakū
kelekele	1. earth
2. bottom (as for ground floor)	adj
kulupu	group
kau ako	group of students
grow	v
tupu lahi	grown-up
le’o	guard
guardian	n
v	tauhi
mate	guess
tokotaha ‘a’ahi	guest
taki	1. leader
taki	2. show the way
guilt	n
adj	halaia
halaia	guilty
kitaa	guitar
gum tree	n
abbrev	pulukamu
fale fakamālohisino	gymnasium
faianga	habit
‘uha maka	hail (weather condition)
‘uha maka	hailstorm
lou’ulu	hair
kosi ‘ulu	haircut
haleli	halal, half
vaeua	1. equal part of
haafe e valu	2. half-past eight
holo	hall
vaha’a holo	hallway
vaeua	halve
hemipeka	hamburger, hammer
hand hamala	hammer
nima	1. body part
tufa	2. hand-out
fakahū	3. hand in
peesi	handbag, handball
handle henipolo	handball
kau	1. thing that may be held
alasi	2. touch
talavou	handsome, handwriting
hang tohi nima	handwriting
tautau	1. suspend
tu’u takai	2. hang around (loiter)
pukepuke	3. hang onto (hold)
tāpuni	4. hang up (put receiver down)
5. Hang on! (wait)	int
hoko	happen
fiefia’anga	happiness
fiefia	happy, harbour
hard taulanga	harbour
faingata’a	1. difficult
fefeka	2. not soft
tātaitaha	hardly (rarely)
maumau’i	harm
utu ta’u	harvest
tatā	hat, hate
have fehi’a	hate
ma’u	1. own
langa ‘ulu	2. have a headache
kai efiafi	3. have dinner
kosi ‘ulu	4. have a hair cut
tui	5. have on (wear), have to (be compelled to)
he head fiema’u ia	have to (be compelled to)
‘ulu	1. body part
taki	2. leader
langa ‘ulu	headache
‘ulu’itohi	heading (title)
mo’ui	health
mo’ui lelei	healthy
fatunga	heap (pile), hear
heard *see hear fanongo	hear, heart
heat mafu/loto	heart
fakamafana	1. warm
māfana	2. warmth
hita	heater (appliance)
mamafa	heavy, height
held *see hold ma’olunga	height
helekopeta	helicopter
hello	int
mālō e lelei	help
tokoni	1. aid
tokoni	2. help yourself (serve yourself)
‘Ikai ke u pule’i	3. I can't help it (I have, no control over it)
tokoni	helpful, hemisphere
her hemisifia	hemisphere
‘eke ki ai	1. ask her
‘ene tohi	2. her book
heni	here
helo	hero
veiveiua	hesitate
hesakoni	hexagon, int, hi
hid *see hide mālō e lelei	hi, hide
high fufū	hide
loloa	1. tall
ma’olunga	2. as for musical note
sū ‘ete	high-heeled shoe
kolisi	high school
tafunga	hill
ia	him
tapa’ikete	hip
nō	hire
ia	his
hisitōlia	history
v	hit
taa’i	1. strike
ikuna	2. winner
hitch-hike	v
manako va’inga	hobby, hold
puke	1. grasp
2. hold-up (robbery)	n, kaiha’a
ta’ofi	3. hold-up (delay)
4. Hold it! (stop)	int
colloq phr	Tu’u
tatali	5. hold on (wait)
ava	hole
holiday	n
adj	‘aho mālōlō
nge’esi	hollow
mā’oni’oni	holy
home	n
adj	‘api
ta’elata	homesick
homueka	homework (school work you
faitotonu	honest, hook
huka	1. curved piece of metal
2. catch	v, huka’i
hope	huka’i
‘amanaki	1. expectation
2. wish	v, faka’amu
tafa’akilangi	horizon
me’atui	1. animal part
me’a fakalea	2. car part
horrible	adj
lilifu	horror
hoosi	horse
hospital	n
hosetia	host
fale tauhi kau ako	hostel
adj	hot
vela	1. very warm
tō atu	2. very good
hotel	n
peleti vela	hot-plate
houa	hour
house	n
ngāue faka’api	housework (domestic work), how
founga	1. in what way
2. how come? (why)	colloq phr, ko e hā hono ‘uhinga?
ka neongo ia	however, huge – industry, huge
human lahi faka’ulia	huge
fakatangata	1. of people
tangata	2. human being, humour
hung *see hang fakakata	humour
fiekaia	hungry, hunt
hurry tuli manu	hunt
fakavave	1. move quickly, 2. hurry up
hurt fakato’oto’o	2. hurry up
fakalavea	1. injure
lavea	2. wounded
fale	hut
au	I
‘aisi	ice
‘aisikilimi	ice-cream
kaveinga haohaoa	ideal
kapau	if
puke	ill
ta’efakalao	illegal
mahaki	illness
fakatātā	illustration
sioloto	imagine
me’a kuo hoko leva	immediate
tuai e kemo	immediately
muli	immigrant
mahu’inga	important
ta’emalava	impossible, improve
in fakalelei’i	improve
‘i loto	1. indicates enclosed place
‘i ‘Aositelelia	2. in Australia
‘i Sanuali	3. in January
‘i he lea Fakapālangi	4. in English
‘i he peni vahevahe	5. in pencil
manako	6. in love
‘i he faingata’a	7. in danger
‘ikai tōmui	8. in time (not late)
fakakau	include
pa’anga hū mai	income
hala	incorrect
fakalahi	increase
tohi hohoko	index
‘i loto fale	indoor
ngāue’anga	industry
infect – is	
fakapipihi	infect
pipihi	infection
takiekina	influence
fulū	influenza
fakahā	inform
fakamatala	information
‘i mu’a ‘ia	in front of
nofo’i	inhabit, inhabitant
initial kakai	inhabitant
‘uluaki	1. first
‘uluaki mata’i tohi	2. first letter of name
huhu	injection
fakalavea	injure
lavea	injury
loto	inner
tonuhia	innocent
inisekite	insect
fakahū	insert
loto	inside, insist
instant vilitaki	insist
momeniti	1. moment
leva	2. immediate
pē	instead
fakahinohino	instruct
akonaki	instruction
tāme’a	instrument (musical)
malu’i	insurance
‘atamai’ia	intelligent
fakakaukau	intend
tokanga	interest
mālie’ia	interested
fakamānako	interesting
initaneti	Internet
fakaheleheleu	interrupt
fekau’aki’anga	intersection
fe’ilo’aki	interview
ki he	into
fakafe’iloaki	introduce
talateu	introduction (of a book)
fa’u fo’ou	invent
tohi fakaafe	invitation, invite
iron fakaafe	invite
‘aione	1. metal
haiane	2. household appliance, 3. as for clothing
is *see be haiane	3. as for clothing, island
it motu	island
ia	1. subject
ne	2. object
ko ia	its (possessive)
sāketi	jacket
‘api pōpula	jail
siaa	jar
meheka	jealous
tangakalī	jeans
seti	jet
siueli	jewel
siueli	jewellery
ngāue	job
tōtō	jog, jogger
join tokotaha tōtō	jogger
fakataha	1. unite
kau	2. as a club
hokotanga hui	joint
fakakata	joke
fononga	journey, joy
judge fiefia	joy
fakamaau	1. person in court
tu’utu’uni	2. make a decision about
fakamaau’i	judgment
suto	judo
huhu’a inu	juice
puna	jump, jumper (clothing)
just falani māfana	jumper (clothing)
pe	1. only
totonu	2. fair
kangakalū	kangaroo keep
tauhi	1. hold on to
fakateketeka	2. keep away
fai ai pe	3. keep going
fakamama’o	4. keep out
tautauhi pe	5. keep up, 6. The teacher kept us in
kept *see keep tauhi ‘i lokoako	6. The teacher kept us in
kī	key
kīpooti	keyboard
me’a ‘ai ‘anga kī	keyring
tefito’i lea	keyword
‘aka	kick
leka	kid (child)
tāmate	kill, killer
kind tokotaha tāmate	killer
loto lelei	1. good hearted
fa’ahinga	2. type
anga lelei	kindness
tu’i	king
‘uma	kiss
peito	kitchen
tui	knee, kneel
knelt *see kneel tu’ulutui	kneel
hele	knife
niti	knit
kau	knob
tukituki	knock, knot
know fakapona	knot
mahino	1. understand
maheni	2. be acquainted with
tala mai kia au	3. Let me know (tell me)
koala	koala
kukapala	kookaburra
faka’ilonga	label
fale kemi	laboratory
ngāue	labour
masiva	lack
tama	lad, ladder
laid *see lay tu’unga	ladder
anovai	lake, lamp
land maama	lamp
fonua	1. opposite of sea
fonua	2. country
tau	3. as for plane, language
lap lea	language
funga	1. body part
takai	2. distance in a pool
lahi	large, last
muimui	1. opposite of first
tolonga	2. endure
faka’osi	lastly
tōmui	late (opposite of early)
kimuini	lately
kimui	later
kata	laugh
kakata	laughter
fō	laundry
lao	law
musie	lawn, lawyer
lay lōea	lawyer
fakatō	1. as for eggs
tuku	2. put, lazy
lead fakapikopiko	lazy
taki	1. go first
leta	2. holder for a dog
taki	leader
kau taki	leadership
lau’i’akau	leaf, leak
lean tutulu	leak
falala	1. incline
tutue	2. thin
puna	leap
ta’u fakalaka	leap year, learn
learnt *see learn ako	learn
si’i taha	least, leather
leave leta	leather
mavahe	1. separate from
mālōlō	2. time off
tuku noa	3. leave alone
tuku pe	4. leave on, 5. leave out
led *see lead tuku ange	5. leave out
hema	left (opposite of right)
nima hema	left-handed
va’e	leg
lemani	lemon
‘omai	lend, length
lent *see lend lōloa	length
si’i	less, lesson
let lēsoni	lesson
fakangofua	1. allow, 2. rent
letter nofo totongi	2. rent
mata’i tohi	1. as of alphabet
tohi	2. correspondence
puha meili	letterbox
letisi	lettuce
levolo	level
tokotaha loi	liar
laipeli	library
laiseni	licence
‘emo	lick, lid
lie tāpuni	lid
loi	1. tell untruths
tokoto	2. lie down
mo’ui	life, lifesaver
lift tokotaha fakamo’ui	lifesaver
hiki	1. raise
lifi	2. elevator, 3. car ride
light lifi	3. car ride
maama	1. opposite of darkness
maama	2. as for electric light
maama	3. not dark
ma’ama’a	4. not heavy
masi	lighter (as for cigarettes), lightning
like ‘uhila	lightning
sai’ia	1. be fond of
tatau	2. similar to
ngata’anga	limit
laine	line
loungutu	lip
vai	liquid
lisi	list, listen
lit *see light fanongo	listen
fakaveve	litter, little
live si’isi’i	little
mo’ui	1. exist
mo’ui	2. opposite of dead
ma’u’anga mo’ui	living (job)
lotofale	living room
moko	lizard, load lobster
local uta/fakaheka ‘uo	load lobster
tokotaha he kolo	1. person from a particular area
fakakolo	2. pertaining to an area
tu’u’anga	location
loka	lock
kupu’i ‘akau	log (wood)
lole	lolly, lonely
long ta’elata	lonely
lōloa	1. opposite of short
faka’amu	2. long for (want)
Fuoloa?	3. How long?(as time)
Lōloa?	4. How long?(as length), 5. long ago
look ono’aho	5. long ago
hila	1. glance
sio ki he	2. look at
tauhi	3. look after
kumi	4. look for
fakatu’otu’a	5. look forward to
toka’i	6. look up to
mata tatau	7. look like (resemble), loose
lose ngahomohomo	loose
mole	1. opposite of find
fo’i	2. opposite of win
na’e mole ‘ene fa’e	3. she lost her mother, (her mother died), loss
lost *see lose mole	loss
pau ke hoko	1. destiny
lahi	2. a lot of
le’o lahi	loud, lounge room
love lotofale	lounge room
‘ofa	1. passionate affection
‘ofa’i	2. feel passionate
ma’ulalo	low
mata’itohi iiki	lower case
mateaki	loyal
monū	luck
monū’ia	lucky
konga	lump
kai ho’atā	lunch
misini	machine mad
‘ita	1. angry
fakasesele	2. insane
mate he manako	3. mad about (loves), madam
made *see make fine’eiki	madam
makasini	magazine
fakalou’akau	magic, magpie
mail manupuna	magpie
tohi	1. correspondence
lī	2. send, main
make tefito’i	main
fa’u	1. manufacture
ngaohi mohenga	2. make the bed
fakakaume’a	3. make friends
fakalelei	4. make up (reconcile)
fa’u	make-up
tangata	male
manu toto māfana	mammal
tangata	man
malava	manage
tokotaha pule	manager
molipeli	mandarin
mango	mango
to’onga	manner (way)
‘ulungaanga	manners (pertaining to, polite behaviour)
fa’u	manufacture
toko lahi	many
mape	map
tapa	margin (of a book), marijuana
mark maliuana	marijuana
fakatonutonu	1. correct
maaka	2. numerical value for work
faka’ilonga	3. spot
maketi	market
mali	marriage
mali	marry, mat
match fala	mat
hoa	1. suit
masi	2. implement for lighting
va’inga	3. game
kaume’a	mate (friend)
fa’ahinga me’a	material, mathematics
maths *see mathematics fika	mathematics
fa’ahinga me’a	1. substance
Ko e hā?	2. What's the matter?
‘Oku mahu’inga	3. It matters a lot
ngofua	may (allowed to)
mahalo	maybe
au	me, meal
mean me’akai	meal
faka’uhinga	1. intend
‘avalisi	2. average
‘ikai ke ‘uhinga	3. I didn't mean it (accidental)
‘uhinga	meaning, means (resources)
meant *see mean ngaahi founga	means (resources)
lolotonga	meanwhile
fua	measure
fua	measurement
kakano’i manu	meat
pai kakano’i manu	meat pie
mekēnika	mechanic
faito’o	medication
faito’o	medicine
talotoloto	medium
fe’iloaki	meet
meleni	melon
vaia	melt
memipa	member
ma’uloto	memorise
manatu	memory
monomono	mend
fakae’atamai	mental, mention
menu fakalau	mention
meniu	1. list in restaurant
meniu	2. list on a computer
moveuveu	mess, message
met *see meet fekau	message
ukamea	metal
founga	method
me’a faka’ata efu	microscope
‘ovani fakamafana	microwave (oven)
ho’atā	midday, middle
taloto	1. central
lotomālie	2. centre
fatu tangata/fefine	middle-aged, midnight
might tu’apō	midnight
hangehangē	1. express possibility
ivi	2. strength
muli	migrant
vaivai	mild
fakakautau	military
hu’akau	milk, milkbar
mind falekoloa	milkbar
fakakaukau	1. consciousness
Manatu’i	2. Keep in mind
Sai pe ia	3. Never mind (don't worry)
Hei’ilo	4. I don't mind, 5. Mind the step (be careful)
mine Tokanga ho laka	5. Mind the step (be careful)
ha’aku	1. possessive
keli	2. underground excavation
fa’ahinga maka koloa	mineral
minisitaa	minister (government), minus
minute kole	minus
miniti	1. unit of time
si’i	2. very small
sio’ata	mirror
loto mamahi	miserable, misplace
miss tuku hala’i	misplace
finemui	1. woman's title
manatu	2. long for
hala	3. opposite of hit
tulia	missing
Fine’eiki	Missus
Tangata’eiki	Mister
hala	mistake
ta’emahino	misunderstand
fio	mix
faifio	mixture, mobile phone
model telefoni mopaila	mobile phone
sīpinga	1. representation
mōtolo	2. person who shows clothes
moteni	modern
fakamāmā	modest
nga’unga’u	moist
momeniti	moment
pa’anga	money
monitā	monitor (computer)
māhina	month
anga feliliuaki	mood (frame of mind)
māhina	moon
anga ‘o e tangata	moral
fakalahi	more
hengihengi	morning
falelotu faka’Isilami	mosque
tokolahi	most
fa’ē	mother
misini	motor
moto paiki	motor bike, motor scooter
mouse moto sikuta	motor scooter
kumā	1. animal
me’a lomi komipiuta	2. computer part
me’a lomi komipiuta	mouse button (computer)
me’a tuku’anga me’alomi komipiuta	mousepad
kava	moustache
ngutu	mouth
‘unu	move
‘unuaki	movement, movie
Mr *see Mister faiva	movie
Ms	Ms
lahi	much
‘ulungaanga fakafonua kehekehe	multicultural
fika liunga	multiplication, multiply
mum *see mother liunga	multiply
fakapoongi	1. unlawful killing
fakapō	2. kill unlawfully
uoua	muscle
fakamalu ‘a tēvolo	mushroom
musika	music
pau	must
he’eku	my
me’a fakalilo	mystery
fa’a tafulu	nag nail
nge’esi nima	1. body part
fa’o	2. metal spike
telefua	naked, name
hingoa	1. title
hingoa	2. given name
hingoa fakafāmili	3. family name
fāsi’i	narrow
angakovi	nasty
pule’anga	nation
tupu’i fonua	nationality, native
nature tu’u fonua	native
‘ulungaanga/natula	1. person's character
‘atakai	2. environment
ofi	near
ofi mai	nearby
meimei	nearly
maau	neat
pau	necessary
kia	neck
fiema’u	need, needle
negative hui	needle
filimi nekativi	1. film
nekativi	2. opposite of positive
li’aki	neglect
kaungā’api	neighbour
ko ē pe ko ē	neither
neave	nerve
manavasi’i	nervous, nest
net pununga	nest
kupenga	1. trap, 2. sport equipment
Net *see Internet neti	2. sport equipment
netipolo	netball (game)
‘ikai ‘aupito	never
fo’ou	new, newspaper
next nusipepa	newspaper
hili eni	1. after this
hoko mai	2. following
kaungā’api	3. next door
lelei	nice
po’uli	night
naiti kalapu	nightclub, night dress
no vala mohe	night dress
hala’atā	2. not at all
hala ha taha	nobody
‘i he po’uli	nocturnal
kamo	nod
noise	n
adv	longoa’a
fakalongoa’a	noisily
longoa’a’ia	noisy
none	pron
ho’atā	noon
hala ha taha	no-one
nor	conj
adj	pe
nomolo	normal
tokelau	north
nose	n
toto e ihu	nosebleed
‘ikai	not
pa’anga	1. money
nouti phrase	2. short piece of writing
tokanga phrase	3. take note (be careful)
hiki nouti	4. take notes
nothing	pron
tokanga	notice
papa fakatokanga	notice board
noun	n
novolo	novel
taimini	now
nowadays	adv
adv	ngaahi ‘aho ni
‘ikai ‘iloa	nowhere
telefua	nude
mata’i fika	1. numeral
lau	2. count
3. a number of	phrase
abbrev	lahi ‘a e, 4. no.
neesi	nurse
nati	1. fruit
fakasesele	2. mad person
nutrition	n
O	fakatupu ivi
talangofua	obedient
obey	v
object	talangofua
me’a	1. thing
2. aim	n
v	taumu’a
ta’eloto	3. be against
ta’eloto	objection
obtain	v
adj	ma’u
mahino	obvious
‘uhinga	occasion
tātātaha	occasionally
ngāue/lakanga	occupation
tahi	ocean, o'clock
odd hoko ‘a e	o'clock
ngali kehe	1. strange
fika ta’ehoa	2. odd number
‘a/’o	of
of course	int
ko ia foki	off
mei ai	1. away from
mei	2. opposite on
Fai mo ke ‘alu!	3. Off you go!
hia	offence, offer
fokotu’u	1. proposal
‘atu	2. present for approval
‘ofisi	office
‘ofisa	officer
faka’ofisi	official
toutou	often
oh!	int
‘o	oil
lolo	1. of petroleum
lolo	2. grease
okay	int
OK	old
motu’a	1. opposite new
motu’a	2. opposite young
vaivai/motu’a	old age, old-fashioned
on ‘olo kuonga	old-fashioned
‘i he	1. representing location
mo’ui	2. opposite off
velahia	3. on fire
‘alu lalo	4. on foot
ma’u taimi	5. on time
holitei	6. on holidays
tafa’aki to’ohema	7. on the left
tafa’aki to’omata’u	8. on the right, 9. on top
once ‘i ‘olunga	9. on top
‘i he taimi ‘e taha	1. one time
‘i he vave taha	2. at once
tu’o taha he uike	3. once a week
taha	one
onioni	onion
tofu pē	only, open
fakaava	1. opposite of closed
tu’a	2. in the open (outside), opening
operate ava	opening
ngāue	1. work
tafa	2. carry out surgery
tafa	operation
lau/fakakaukau	opinion
faingamālie	opportunity
fakafepaki	oppose, opposite
orange fepaki/fehangaaki	opposite
lanu moli	1. colour
fo’i moli	2. fruit, orchestra
order kau ifi	orchestra
hokohoko	1. numerical sequence
tu’utu’uni	2. direction for a supply
fakahokohoko	3. put in sequence
‘ota	4. arrange supply of, ordinary
organ noa/anga fai	ordinary
‘ōkani	1. musical instrument
konga ‘o e sino	2. body part
kautaha	organisation
teuteu/fakamaau	organise
tupu’anga	origin
kehe	other
ka ‘ikai	otherwise, our
out he’eta/hota/hotau	our
tu’a	1. opposite in
kitu’a mei	2. out of
Tāmate’i e maama!	3. Lights out!
ngaohi mei he	4. made out of
tapu hū mai	5. out of bounds
‘osi hono taimi	6. out of date
maumau	7. out of order
ta’e ma’u ngāue	8. out of work
‘i tu’a	outside, oval (shape)
over fuopototo fuololoa	oval (shape)
‘osi	1. finished
‘i	2. pertaining to location
hulu	3. over and over
ki hē	4. over there
tō ki lalo	5. fall over
fonu hake	overcrowded
fai ‘o hulu	overdo
tōmui	overdue
misini hulu	overhead projector
fanongo atu	overhear
‘anepō	overnight
ki muli	overseas
mo’umohea	oversleep
fakalaka	overtake
mo’ua mai	owe, owing to (due to)
own mo’ua kia	owing to (due to)
ma’u	1. have
‘ene pa’anga	2. his own money
‘o’ona	owner
‘osikena	oxygen
fa’oaki	pack
pele	pack of cards
kofukofu si’i	packet
pepa faitohi	pad (as note-pad)
konga kelekele kuo ‘atakai	paddock, page
paid *see pay peesi	page
mamahi	pain
vali	paint
vali	painting
fakahoa	pair
tea	pale
fakapaku	pan
talausese	pants
sitōkeni kili	pantyhose
pepa	paper
palakalafi	paragraph
palāleli	parallel
tapafā palāleli	parallelogram, parent
park mātu’a	parent
paaka	1. green space
tau	2. as a car
konga	part
tu’u fakakalama	participle (grammar)
fakaikiiki	particular
hoa	partner
fakataimi	part-time, party (gathering)
pass paati	party (gathering)
laka ‘i	1. go by
lava	2. opposite of fail
‘oange	3. hand over
paasi lēlue	4. train pass
vaha’a hala	passage
pāsese	passenger, passport
past paasipooti	passport
kuo ’osi	1. time gone by
‘alu hake	2. walk past
haafe e fā	3. half past three
kuo hili	4. past tense, pasta
paste pasitā	pasta
me’afakapipiki	1. glue
fakapipiki	2. stick with paste, path
patient hala	path
mahaki	1. a person under, medical treatment
kātaki	2. calm under stress
tatali si’i	pause, paw
pay pesipesi	paw
vahe	1. earnings
totongi	2. provide with money
pī	pea
nonga	peace
nonga	peaceful
peni	pen
penivahevahe	pencil
kato penivahevahe	pencil case
penikuini	penguin
tapanima	pentagon
pepa	pepper
peseti	per cent
fakapeseti	percentage
haohaoa	perfect
fakahoko	perform
kaloni	perfume, perhaps
period mahalo pe	perhaps
piliote	1. school day division
fakamāhina	2. pertaining to menstruation
taimi	3. amount of time, permission
permit ngofua	permission
laiseni	1. licence
fakangofua	2. allow
tokotaha	person
fakaloto’i	persuade
pele	pet, petrol
phone *see telephone penisini	petrol, photocopy
photograph fotokopi	photocopy
tā	1. picture
faitā	2. take a picture
kupu’i lea	phrase
fakaesino	physical
taha tā piano	pianist, piano
pick piano	piano
fili	1. choose
anga houtamaki	2. pick on (bully)
to’oto’o ha lea Fakapālangi	3. pick up some English
fili ha’o me’a	4. take your pick
kaime’akai	picnic
fakatātā	picture
konga	piece
fokotu’una	pile
fo’i’akau	pill
pilo	pillow
pailate	pilot
pine	pin
fainā	pineapple, pipe
pity paipa	pipe
pango	1. shame, 2. feel sorry for
place fakame’apango’ia	2. feel sorry for
feitu’u	1. location
hoko	3. take place (occur), 4. my place (home)
plain hoku ‘api	4. my place (home)
lau tokalelei	1. field
ta’e faka’ofo’ofa	2. ordinary, 3. It's plain (clear)
plan ‘Oku mahino	3. It's plain (clear)
palani	1. scheme, 2. organise
plane *see aeroplane fa’ufa’u/palani	2. organise
palanite	planet, plant
plastic ‘akau	plant
pelisitiki	1. resinous substance
molū	2. mouldable
peleti	plate (household item), platform
tali’anga lēlue	1. on station
papa tulihopo	2. for diving, platypus
play peletipusi	platypus
fo’i faiva	1. drama
va’inga	2. have fun
va’inga	3. play a game
tā CD	4. play a CD
mala’eva’inga	playground
fakamānako	pleasant
please	int
fiemālie	pleased
fiefia	pleasure, plenty
plug lahi ‘ānoa	plenty
‘umosi	1. stopper
palaki	2. electrical, 3. plug in
plural palaki	3. plug in
palulali	1. more than one
palulali fakakalama	2. grammar form, plus
pocket mo e/tānaki	plus
kato	1. pouch
pa’anga tānaki	2. pocket money
maau	poem
tokotaha fa’u maau	poet, poetry
point maau	poetry
mui māsila	1. sharp end
‘uhinga	2. reason
poini tesimale	3. numerical value
tuhu	4. gesture with finger
tuhu’i	5. point out
tefito’i fakakaukau	6. point of view
hoka	poke
pou	pole, police
polish polisi	police
me’a fakangingila	1. substance used for shining
fakangingila	2. make glossy
anga faka’apa’apa	polite
politiki	politics
faka‘uli’i	pollute
‘uli	pollution
toka’anga vai	pool (of water), poor
masiva	1. opposite rich
2. not very good	adj, kovi
faka’ofa	3. pitiable
pop *see popular	abbrev
popular	adj, manakoa
tokolahi ‘o e kakai	population
tu’unga	1. location
‘uhinga	2. viewpoint on
adj	positive
positivi	1. opposite negative
fakapapau’i	2. sure
possess	v
koloa ‘oku te ma’u	possession
malava	possible
possum	n
v	posomu
lī	post
sitapa	postage stamp
postcard	n
positi ‘ofisi	post office
papa fakatātā	poster
pot (container)	n
pateta	potato
kapa ‘akau	pot plant
pouch	n
pauta	powder, power
mālohi	1. strength
2. in power (in charge)	phrase, ma’u mafai
mālohi/iviivi	powerful
power point	phrase
adj	poini ‘uhila
kau ki he anga mo e ngāue	practical
angafai	practice
practise	v
praise	fai
fakahikihiki	1. approval
2. express approval	v
v	fakamālō
lotu	pray
lotu	prayer
precious	adj
v	mahu’inga
fili	prefer
feitama	pregnant
prejudice	n
premier	hehema ke fehi’a
palēmia	1. state government leader
2. leading	adj
teuteu	preparation, prepare preposition
prescription (doctor's)	prepare preposition
tohi mei he toketā	present teuteu takinauna
me’a’ofa	1. gift
foaki	2. give out
‘i heni	3. opposite absent
lolotonga	4. at present (now), president
press palesiteni	president
mitia	1. media
lomi	2. push
fakangalingali	pretend
talavou	pretty
ta’ofi	prevent
kimu’a	previous
mahu’inga	price
huhu	prick
laukau	pride
‘uluaki	primary
akoteu	primary school, prime minister
principal palēmia	prime minister
pule ako	1. school head
tu’ukimu’a	2. leading, principle
print tefito’i mo’oni	principle
tohi nima	1. of handwriting
paaki	2. of machine
misini paaki	printer (computer)
pilīsone	prison
fakapulipuli	private
pale	prize
fakaangaanga	probability
hangehangē	probable
mahalo	probably
palopalema	problem
hokoatu	proceed
founga	process, procession
produce fononga	procession
fua	1. yield
ngaohi	2. make
me’a kuo fa’u	product
ngāue	profession
palōfesa	professor
tupu	profit
polokalama	program
lalaka	progress, project (as school project)
promise fekumi fakaako	project (as school project)
tala’ofa	1. assurance
palōmesi	2. vow
fetonginauna	pronoun
pu’aki	pronounce
hono pu’aki	pronunciation
fakamo’oni	proof
totonu	proper
fakalelei	properly
koloa	property
malu’i	protect, protection
protest malu’i	protection
fakafepaki	1. objection
fepaki	2. object
polepole	proud
fakamo’oni’i	prove
fakaai	provide
papu	pub
fakapule’anga	public
ako pule’anga	public school, public transport
pull me’alele fakapule’anga	public transport
toho	1. tug
holoki	2. pull down (demolish)
fusi	3. pull up (stop)
lava ‘o fakaakeake	4. pull oneself together
pamu	pump
tauhi taimi	punctual
tautea’i	punish, punishment
pupil tautea	punishment
tama’uli	1. eye part
tokotaha ako	2. school student
ma’a	pure, purple
push vaioleti	purple
teke	1. exert force, 2. push in (go before your turn)
put teke’i	2. push in (go before your turn)
tuku	1. place
tuku ki tafa’aki	2. put away (pack up)
toloi	3. put off (delay)
tui vala	4. put on (dress in)
tamate afi	5. put out (as fire)
kātaki’i	6. put up with (endure)
fifili	puzzle
vala mohe	pyjamas
poto taau	qualify (make competent)
anga	quality
hono lahi	quantity
kē	quarrel
kuata	quarter
kuini	queen
fehu’i	question
tu’u fakaholoholo	queue
fakavave	quick
fakavave	quickly
fakalongolongo	quiet
fakalongolongo	quietly
tuku/li’aki	quit
meimei	quite, race
fe’auhi	1. competition
fa’ahinga	2. ethnicity
lova	3. compete
laulanu	racism
letiō	radio
letiasi	radius
‘akau fakalava	railing
halanga lēlue	railway
‘uha	rain
kote faka’uha	rain coat, raise
ran *see run hiki	raise
fokotu’utu’u	range
tu’unga	rank
vave	rapid
tātātaha	rare
veli	rash (skin eruption)
sai ange	rather (to a certain extent), raw
reach mata	raw
a’u	1. arrive at
ta’ea’u	2. out of reach (unobtainable)
tali	react
tali	reaction
lautohi	read
maau	ready
mo’oni	real
fakatokanga’i	realise
mo’oni	really
mui	rear
‘uhinga	reason
ma’u	receive (get)
toki hoko	recent
mālōlō si’i	recess (morning tea)
fakakaukau	reckon (think or suppose)
fakatokanga’i	recognise, record
recount lekooti	record
fakamanatu	1. story genre, 2. narrate
recover fakalau	2. narrate
toe ma’u	1. get back
ake	2. get better
tapafā tuliki totonu	rectangle
kulokula	red
holoki	reduce
tuku atu	refer
fakamaau va’inga	referee
‘aisi	refrigerator
taha kole hufanga	refugee
fakafisi	refuse
feitu’u	region
fakatomala	regret
ma’u pe	regular
ma’u pe	regularly
kainga	relation (kin)
felāve’i	relationship
kainga	relative
mālōlō	relax
lotu	religion
nofo	remain
lau	remark
manatu’i	remember
fakamanatu	remind
me’a fakamanatu	reminder, remove
rent ‘ave	remove
nofo totongi	1. payment for accommodation
totongi nō	2. hire
toe fai	repeat
fetongi	replace, reply
report tali	reply
fakamatala	1. written account
fakahā	2. give an account
faiongoongo	reporter
lepupelika	republic, request
tohi tangi	1. petition
kole	2. ask for, rescue
reserve fakahaofi	rescue
pa’ake	1. park
ta’ofi	2. keep aside
tokotaha nofo’api	resident
faka’apa’apa	respect
fatongia	responsibility, responsible
rest fatongia’aki	responsible
mālōlō	1. relaxation
mālōlō	2. relax
toe	3. remainder
fale kai	restaurant
fale mālōlō	rest room, result
return ola	result
foki	1. arrival back
foki	2. go back to
fakafoki	3. give back to, 4. return tickets
reverse totongi ‘osi	4. return tickets
mui	1. opposite forward
holomui	2. go backwards, revise
revolution sivi	revise
takai kakato	1. full circle
liukava	2. war
pale	reward
anga hokohoko	rhythm
līpine	ribbon
laise	rice
koloa’ia	rich
tukuange	rid, ride
right heka	ride
tonu	1. opposite wrong
mata’u	2. opposite left
holo	3. direction
totonu	4. just claim
sai pe	5. all right (as for health)
‘io	6. all right (as for agreement)
taimini	7. right now (immediately), right angle
ring tuliki totonu	right angle
mama	1. jewellery
tatangi	2. as a phone, 3. as a bell
ripe rise tā momoho	3. as a bell
langa	1. ascent
tu’u hake	2. get up
fakatu’utāmaki	risk
vaitafe	river
hala	road
‘u’ulu	roar
tangata ukamea	robot
maka	rock
tāputa	rockpool, rod
rode *see ride va’akau	rod
tohi ui	1. absentee list
mā	2. form of bread
teka	3. move by turning over
‘ato	roof
loki	room
aka	root, rope
rose maea	rope
lose	1. flower
petepete	rough round
fuopotopoto	1. circular, 2. round the corner
row ‘i he tuliki	2. round the corner
‘otu	1. arrangement in a line
vātau	2. fight
‘a’alo	3. as a boat
fakatu’i	royal
olo	rub
lapa	rubber
veve	rubbish
anga pango	rude, ruin
rule faka’auha	ruin
tu’utu’uni	1. regulation
laine’i	2. as a line
pule	3. govern, ruler (school equipment)
run lula	ruler (school equipment)
lele	1. move fast
tafe	2. a river runs into the ocean
hola	3. run away from
‘osi	4. run out of
tui’i	5. run over (with a car)
kaka’anga	rung (of a ladder)
hono ua	runner-up
hafu e ihu	runny nose
fakavave	rush
loto mamahi	sad, safe
said *see say malu	safe
lā	1. part of ship
tukulā	2. cause movement of ship, using wind
sālati	salad
vāhenga	salary
fakatau	sale
māsima	salt
tatau	same
‘one’one	sand
saniteli	sandal, sandwich
sang *see sing sanuisi	sandwich
fiemālie	satisfaction
fakafiemālie	satisfactory
fiemālie	satisfied
fiemālie	satisfy
lolo/kelevi	sauce, sausage
save sōsisi	sausage
fakahaofi	1. rescue
tauhi ‘i he komipiuta	2. keep on computer, 3. keep as money
saw pa’anga tānaki	3. keep as money
kili	1. tool
lau	say scale
‘uno	1. covering on animals
me’a fua mamafa	2. measuring device
si’i	scarce
sikaafi	scarf
potu	scene
funga fonua	scenery
‘api ako	school
sū ako	school shoe
saienisi	science
helekosi	scissors, score
kai	1. points made in a game
maaka	2. to get points
kaikaila	scream
puipui	screen
sikalu	screw
tahi	sea, seagull
search tala	seagull
kumi	1. the act of searching
kumi	2. look for
faha’ita’u	season, seat
second sea	seat
sekoni	1. unit of time
ua	2. after first, secondly
secret ko hono ua	secondly
me’a fakafufū	1. something hidden
fakafufū	2. unknown by others
vahe	section
sio/’ilo	see
tenga	seed
kumi	seek
tātātaha	seldom
fili	select
siokita	selfish
fakatau	sell, send
sense ‘ave	send
ongo	1. one of the five faculties
‘uhinga	2. make sense (be intelligible), sensible
sent *see send fakapotopoto	sensible, sentence
separate sētesi	sentence
tu’usi	1. disconnected
fakamavahe	2. to keep apart
hokohoko	sequence, series
serious holongā	series
mahu’inga	1. important
fakamatoato	2. opposite of lighthearted
sevāniti	servant
tufa	serve, service
set ngaahi ngāue	service
fokotu’u	1. to put in a particular place
seti	2. a group of things, 3, set off (go)
4. set out (put in order)	set off (go)
settle tukuange fokotu’utu’u teuteu	5. set up (prepare)
nofo’i	to live in
lototaha	2. settle on (agree on)
nofo’anga	settlement
tokotaha ‘oku ne nofo’i	settler
ngaahi	several
tuitui	sew
ko ‘ete tangata/fefine	sex
fekau’aki mo e tangata/fefine	sexism
malumalu	shade
‘ata	shadow
lulu	shake
te u/pau	shall
mamaha	shallow
fakamā	shame
semipū	shampoo, shape
share fōlinga	shape
konga	1. portion
vahevahe	2. divide up
māsila	sharp
me’a fakamata	sharpener
tele	shave
ia	she, sheep
sheet sipi	sheep
la’ipepa	1. of paper
kafu	2. of bedding
funga laupapa	shelf
nge’esi fīngota	shell (of sea)
fakaunga	shelter
ngingila	shine
ngingila	shiny
vaka	ship
sote	shirt
‘ohovale	shock
sū	shoe, shoot
shop fana’i	shoot
falekoloa	1. place to buy goods
fakatau	2. buy goods, shore
short matāfanga	shore
nounou	1. opposite tall
nonou	2. opposite long
founga nounou	short cut, shorts (clothing)
shot talausese mutu	shorts (clothing)
fana	1. gunfire
tonu	should
kaila	shout, shove
show teke’i	shove
faka’ali’ali	1. display
sou	2. as on TV, 3. show off (be pretentious)
shower fie hā	3. show off (be pretentious)
mosimosi	1. weather condition
saoa	2. wash oneself
saoa	3. bathroom apparatus
mingi	shrink
tāpuni	shut
mā	shy
puke	sick
loki mahaki	sick bay
tafa’aki	side
tafa’aki	sideways, sight
sign vakai/sio	sight
papa tohi fakamatala	1. information board
fakamo’oni	2. write one's signature
faka’ilonga	signal
fakamo’oni	signature
talanoa tuhutuhu	sign language
fakalongo	silence
sīlongo	silent
silika	silk
laupisi	silly
siliva	silver
tatau	similar
faingofua	simple
hiva	sing
taautaha	single
falani loto	singlet, singular (grammatical)
sink singulali	singular (grammatical)
me’a fuluipu’anga	1. tub for washing
ngoto	2. go down
Tangata’eiki	Sir (respectful form of address)
tuofefine/tokoua	sister, sit
skate tangutu	sit
sikeiti	1. glide over the ground
sikeiti	2. equipment for skating
skateboard – so	
sikeitipooti	skateboard
sikeitipooti	skateboarding
sikī	ski
sikī	skiing
pōto’i	skilful
poto	skill, skin
skip kili	skin
puna	1. jump
fakalaka	2. pass over
piva	skirt
langi	sky
kananga	slang
paa’i	slap
pōpula	slave
mohe	sleep, sleepy
slept *see sleep fiemohea	sleepy
konga	slice
heke	slide
sino si’i	slim
sengai	sling
hekea	slip
silipa	slipper (type of shoe)
hekeheke	slippery
hifi’i	slit, slope
slow tahifo	slope
tuma	1. opposite fast
tuai	2. behind time
māmālie	slowly
si’isi’i	small
poto	smart (clever), smash
smell haveki	smash
nanamu	1. odour, 2. inhale an odour
smile mihi’i	2. inhale an odour
malimali	1. facial expression, 2. make facial expression
smoke malimali	2. make facial expression
‘ahu/kohu	1. visible substance from fire
ifi	2. inhale a substance
molemole	smooth
kai ma’ama’a	snack
ngata	snake
mafatua	sneeze
sinou	snow
ko ia	so (consequently)
soap – sphere	
koa	soap
soka	soccer
sōsaieti	society, sock (clothing)
soft sitōkeni	sock (clothing)
molū	1. opposite hard
le’osi’i	2. opposite loud, softly
sold *see sell fakale’osi’i	softly
me’a ma’opo’opo	1. three dimensional figure, 2. matter that is not liquid or gas
solution fefeka	2. matter that is not liquid or gas
mo’oni	1. answer
vaihu’i	2. mixture (scientific)
solova	solve
ha/ngaahi	some
ha taha	somebody
ha taha	someone
taimi ‘e ni’ihi	sometimes
foha	son
hiva	song, soon
sore vave mai	soon
mamahi	1. painful
pala	2. painful spot
mamahi e monga	3. sore throat
fakamolemole	sorry
fakafa’afa’ahinga	sort
laumālie	soul
ongo	sound
supo	soup
mahi	sour, south
space tonga/saute	south
vavā	1. outside earth's atmosphere
‘atā	2. room
sipeiti	spade
me’a ‘e taha	spare
lea	speak
makehe/fungani	special, speech
speed lea	speech
vave	1. rapidity
vave	2. go fast
sipela	spell, spend
spent *see spend ngāue’aki/fakamole	spend
‘ātakai	sphere
hua’i	spill
vilo	spin
laumālie	spirit (soul)
‘anu’anu	spit
fakapihi	splash
mafahi	split, spoil
spoke *see speak maumau’i	spoil
sepuni	spoon
sipoti	sport
mala’e sipoti	sports oval, sports shoe
spot sū sipoti	sports shoe
faka’ila	1. circular pattern
mamahi	2. sore
feitu’u	3. place
‘ilo	4. see, spread
spring folahi	spread
faha’ata’u matala	1. season, 2. jump
spy mahiki	2. jump
asiasi	1. person who keeps secret, watch on others, 2. watch
square fakasio	2. watch
fuotapafā	1. plane figure
tapafā	2. shaped as a square
loki e kau faiako	staffroom
siteisi	stage, stair
stamp sitepu	stair
sitapa	1. as for postage
sitapa’i	2. impress a mark on, 3. strike with foot
stand fakapatū	3. strike with foot
tu’u	1. take upright position
tu’u ki mui	2. stand back
poupou	3. stand for (signify)
fakafofonga’i	4. stand up for (defend)
‘Ikai matu’uaki	5. I can't stand it (I hate it), standard
star tu’unga	standard
fetu’u	1. astral body
sitaa	2. famous actor, singer etc.
sitaa	3. shape
alamea	starfish, start
kamata	1. beginning, 2. begin
state kamata	2. begin
lea	1. say
vahe fonua	2. political division, statement
station tu’unga lea	statement
tau’anga lēlue	1. of railway
‘api polisi	2. police station
maka fakamanatu	statue
nofo	stay
tu’uma’u	steady
siteiki	steak
kaiha’a	steal
mao	steam
sitila	steel
lilifa	steep, stem
step kau	stem
laka	1. move using feet
sitepu	2. stair
tokanga	3. watch your step (be careful)
tuonga’ane	stepbrother
mali ‘o ‘ete fa’e	stepfather
mali ‘o ‘ete tamai	stepmother, stepsister
stick tokoua	stepsister
fakama’u	1. fasten
‘akau	2. piece of wood
pikipiki	sticky, stiff
still fefeka	stiff
tu’u ma’u	1. without moving
ka neongo ia	2. yet, sting
stink huhu	sting
namu kū	1. bad odour
namu kū	2. smell very bad, stir
stole *see steal heu	stir
kete	stomach
langa kete	stomach-ache, stone
stood *see stand maka	stone
tuku	1. cessation
tu’u	2. halt
fale koloa	store
fungavaka	storey
taufa	storm
talanoa	story
sitou	stove, stove top
straight funga sitou	stove top
hangatonu	1. not crooked
hika	2. not wavy or curly (of hair)
hangatonu	3. straight ahead
fakahika	straighten
sivi	strain
faikehe	strange
sola	stranger
sitolōpeli	strawberry
vaitafe	stream
hala	street, strength
stress ivi	strength
fakamamafa	1. put emphasis on
fakakulukia	2. tension, strict
strike anga fefeka	strict
tau	1. hit
tā	2. blow
fakafisi ke ngāue	3. on strike (not working)
tuaine	string
konga	strip
amohi	stroke
mālohi	strong (powerful), struggle
stuck *see stick fetakai	struggle, student
study tokotaha ako	student
loki ako	1. room of house
ako	2. endeavour to acquire, knowledge, stuff
ngaahi me’a	1. material
fa’oaki	2. push
vale	stupid, style
subject founga/akenga	style
lēsoni	1. course of study
tu’unga lea	2. topic
kakano	substance
kole	subtract
kole	subtraction
kolo	suburb
succeed – survey	
lava me’a	succeed
lava me’a	success
komo	suck
fakatu’upakē	sudden
fakatu’upakē	suddenly
ongo’i faingatā’ia	suffer
suka	sugar
fokotu’u atu	suggest, suggestion
suit fokotu’u	suggestion
suti	1. clothing
fe’unga	2. be appropriate
fe’unga	suitable
fakakatoa	sum (total)
sama	summer
la’ā	sun
fohia	sunburn
matasio’ata	sunglasses
tatā	sunhat
la’ā	sunny
kilimi malu’i fohia	sunscreen, sunshine
supply maama mei he la’ā	sunshine
ngaahi me’a	1. provisions, 2. provide
support fakaai	2. provide
tokoni	1. assistance
tokoni’i	2. provide assistance
fakamahalo	suppose (assume), sure
surf fakapapau	sure
ngalu	1. seaswell
fānifo	2. ride a surfboard
funga	surface
papa fānifo	surfboard, surfer
surgery tokotaha fānifo	surfer
kiliniki	1. doctor's room
tafa	2. operation by doctor, surname
surprise fakaiku	surname
ta’e’amanekina	1. unexpected event
fakaofo	2. catch unprepared
faka’ohovale	3. unexpected
tukulolo	surrender, surround
survey kāpui	surround
savea	1. poll
savea	2. ask questions of
hao mei he	survival
hao mei he	survive
tokotaha swag	swagman, swallow
swam *see swim folo	swallow
kapekape	1. use bad language
fakapapau	2. take oath of truth
tafi	sweep
melie	sweet
koane melie	sweet corn
kumala	sweet potato
kakau	swim
tokotaha kakau	swimmer
kaukau	swimming
katoanga kakau	swimming carnival, swimming costume
swing vala kaukau	swimming costume
ngaluelue	1. sway, 2. play equipment
switch heke	2. play equipment
me’a kamosi	1. device for turning on/off
fetongi	2. change
fufula	swollen
tunga’iva’e fufula	swollen ankle
heletā	sword, table
tēpile	1. furniture
lisi	2. list
pingipongo	table tennis
fo’i’akau	tablet (medication), tail
take hiku	tail
‘ave	1. seize
fuoloa	2. last for (as time)
kole	3. take away (mathematical)
to’o	4. take away (remove)
me’akai fakatau	5. take away (fast food)
vete	6. take off (as clothing)
puna	7. take off (as plane), tale
talk fananga	tale
pōtalanoa	1. conversation
talanoa	2. converse
lōloa	tall
lalata	tame, tan
fakala’ā	1. sunbake
melomelo	2. colour
tangike	tank
tepi	tap (as for water)
tepi	tape (record), task
taste ngāue	task
‘ahi’ahi	1. sample
‘oku ifo e me’akai	2. the food tastes good, tasty
taught *see teach ifo	tasty
tukuhau	tax, taxi
tea tekisī	taxi
tī	1. beverage
kai efiafi	2. dinner
ako’i	teach
faiako	teacher
tokoni faiako	teacher's aide, team
tear timi	team
hae	1. rip
lo’imata	2. liquid from the eye
fakamatalili	tease
tekinolosia	technology, teenager
telephone talavou	teenager
telefoni	1. device for phoning
telefoni	2. ring
fale telefoni	telephone booth, telescope
television me’a faka’ata	telescope
televisone	1. receiver for broadcasts, 2. TV
tala	tell
anga ‘o e loto	temper
fua māfana	temperature
temipale	temple
fakataimi	temporary
tenisi	tennis, tent
term teniti	tent
teemi	1. a period of time
fakalea	2. a naming word
faka’ulia	terrible
fakamanavahē	terrific, test
sivi	1. examination
sivi	2. check, text
thank potu tohi	text
fakamālō	1. express appreciation
fakamālō	2. give thanks
3. thank you (polite expression	int, of gratitude), that
ko e	1. indicator of person or thing
ko ia/ena	2. used as subject of relative, clause
ko e	the
fale faiva	theatre
‘enau	their
kinautolu	them
toki/leva	then
‘i ai	there
ko ia ai	therefore
me’a fua māfana	thermometer
kinautolu	they
matolu	thick
kaiha’a	thief
manifi	thin
fakakaukau	think, thong (footwear)
thought silipa	thong (footwear)
fakakaukau	1. idea
vavae/filo	1. cotton, 2. put through eye of needle
threw *see throw tui	2. put through eye of needle
mei he	through (from one side to, another)
tolo	throw
motu’atuhu	thumb
mana	thunder
‘u’ulu e mana	thunderstorm
pehe	thus
tiki	tick (indicate correctness)
tikite	ticket
tahi	tide, tidy
tie maau	tidy
hekesi	1. clothing
fakama’u	2. fasten
mahanga	3. equal place, tight tilt
time mano’o fakatafa	tight tilt
taimi	1. measurement of duration
ma’u taimi	2. in time (not late)
ma’u taimi	3. on time (at the appointed time)
taimi ‘e ni’ihi	4. at times
taimi lelei	5. a good time
māmālie	6. take your time (don't rush)
Ko e fiha eni?	7. What's the time?
ua liunga fā	8. two times four (mathematical), timetable
tip taimi tēpile	timetable
fakasisi	1. hint
tu’unga veve	2. rubbish dump
fulihi	3. tilt
ngata’anga	4. pointed extremity
mahua	5. tip over (spill)
tisiu	tissue
hingoa	title
kia	to
‘aho ni	today
motu’a va’e	toe
fakataha	together, toilet
told *see tell toileti	toilet
temata	tomato
‘apongipongi	tomorrow, tongue
took *see take ‘elelo	tongue
me’a ngāue	tool
nifo	tooth, toothache
top langa nifo	toothache
tumu’aki	1. highest point
falani	2. clothing, topic
tore *see tear topiki	topic
fakakatoa	1. complete amount
tanaki	2. add up
ala	touch
tua	tour
taulani	tow
atu/ange	towards
taueli	towel
taua	tower
kolo	town
me’a va’inga	toy
fakatotolo	trace
halanga	track (pathway)
vala sipoti	tracksuit, tractor
trade misini toho	tractor
fefakatau’aki	1. exchange of commodities
fefakatau’aki	2. carry on trade, traffic
train fe’alu’aki he hala	traffic
lelue	1. means of transport, 2. practise
trap ako	2. practise
tauhele	1. device for catching things
puke	2. catch
tapafā ‘ikai palāleli	trapezium
folau	travel
mala	tread
faito’o	treat (as a disease)
‘akau	tree
tetetete	tremble
tapatolu	triangle
‘asi fakatapatolu	triangular prism
ha’a	tribe
kākā’i	trick, trim
trip kosikosi	trim
folau	1. journey
humu	2. fall over, tropical
trouble talopiki	tropical
palopalema	1. problem
hoha’a	2. cause worry
faingatā’ia	3. in trouble with
talausese	trousers
loli	truck
mo’oni	TRUE, trunk (as of elephant)
try ihu’i ‘elefanite	trunk (as of elephant)
feinga	1. attempt
feinga malohi	2. try hard
‘ahi’ahi	3. try on (as for clothing)
‘ahi’ahi	4. try out for (audition for)
falani	T-shirt
topu	tub, tube
turn tiupi	tube
tafoki	1. move around
fakatatau	2. action following someone, else's
hoko	3. turn into (become)
tamate’i	4. turn off (switch off)
fakamo’ui	5. turn on
tau mai	6. turn up (arrive)
tu’o ua	twice, twist
type mio’i	twist
fa’ahinga	1. kind
taipe	2. use a machine to write
va’e kā	tyre
mata kovi	ugly
fakamalu	umbrella
fa’etangata	uncle
‘ikai ‘ilo ha me’a	unconscious
‘i lalo	under
kātekina	undergo
lolofonua	underground
laine’i	underline
‘i lalo	underneath
vala loto	underpants
mahino	understand
vala loto	underwear
vete	undo
unemployed	adj
teunga	uniform
unioni	union
feleti	1. type of housing
‘iuniti	2. measurement
unite	v
‘univeesi	universe
‘univesiti	university
until	prep
adj	kae’oua
anga kehe	unusual
ki ‘olunga	up (to a higher place)
upon (up and on)	prep
adj	‘i he funga
‘i ‘olunga	upper
tu’u tonu	upright
upset	adj
adj	lotomamahi
fulihi	upside-down
‘i ‘olunga	upstairs
urge	v, faka’ai’ai, urgent us
use fakavavevave kitautolu	urgent us
ngāue	1. the act of using
fakangāue’i	2. employ
motu’a	used (not new)
huhu ta’ofi	vaccination
toma	vain
tele’a	valley, valuable
value mahu’inga	valuable
mahu’inga	1. worth
mahu’inga’ia	2. to hold in high esteem
veeni	van (truck)
fa’ahinga kehekehe	variety
liliu	vary
liliu	various
vesitapolo	vegetable
ngoue vesitapolo	vegetable garden
tokotaha kai vesitapolo	vegetarian
me’alele	vehicle
lenitu	verandah
veape	verb, very
vet *see veterinarian matu’aki	very
toketā manu	veterinarian
vitiō	video (recording)
‘uhinga	view
kolo	village
fakamālohi	violent
vaiolini	violin
‘a’ahi	visit
tokotaha ‘a’ahi	visitor
le’o	voice
volipolo	volleyball (game)
voliume	volume
fili	vote
vauele	vowel
folau	voyage
vahe	wage
tatali	wait
‘a	wake
lue	walk
lue’anga	walkway
holisi	wall
wallaby – Web	
ualapi	wallaby
wallet	n, ualeti
‘alu fano	wander
want	v
tau	war
ualata	waratah
wardrobe	n
adj	kōpate vala
māfana	warm (opposite cool)
toto māfana	warm-blooded
warn	v
fakatokanga	warning
kaukau	1. clean with water
2. wash up (of dishes)	phr v, fufulu ipu
misini fō	washing machine (clothes)
v	waste
fakamole	1. employ uselessly
veve	2. rejected products
uasi	1. timepiece
fakasio	2. look at
3. watch out (be careful)	phr v
water	tokanga
vai	1. liquid
2. moisten	v
meleni	watermelon
uatele	wattle tree
peau	1. swell of water
ta’alo	2. make a hand signal
wavy	adj
te’elango	wax, way
hala	1. road
2. a long way	phrase, mama’o fau
founga lelei	3. a good way
4. give way	phrase
pron	faka’atā
kitautolu	we
vaivai	weak
wealth	n
adj	koloa
koloa’ia	wealthy
me’a tau	weapon
v	wear
mōlia	1. erode
tui	2. put on (as for clothing)
web (as for spider)	n
abbrev	mata manu
mali	wedding
uike	week
mamafa	weigh, weight
welcome fua mamafa	weight
mālō e lelei	1. a kind greeting
2. You're welcome! (polite	int, response to thank you), well
vaitupu	1. hole in earth
lelei	2. in good health
sai	3. in a satisfactory manner
4. Well! (expresses relief, pause)	int, 5. Well done!
went *see go Lelei ‘aupito!	5. Well done!, west
wet hihifo	west
fakaviku	1. moisten
viku	2. opposite dry
ko e ha	what (interrogative)
ve’eteka	wheel
‘anefe	when (interrogative)
ha taimi pe	whenever, where (interrogative)
which ko fe	where (interrogative)
fika fe	1. what one of a number, (interrogative)
ko e fe	2. relative (refers to something, previously mentioned)
lolotonga	while
uipi	whip, whisper
whistle fanafana	whisper
mapu	1. make a musical sound
me’a ifi	2. equipment used to make, a sound
hinehina	white, whiteboard
who palakipoe hinehina	whiteboard
‘a hai	1. interrogative
ko hai	2. relative pronoun
fakakatoa	whole
ko e ha	why
fakalielia	wicked
fālahi	wide
uitou	widow
uitou	widower
ma’okupu	width, wild
will kaivao	wild
te/’e	1. auxiliary used in future tense
tohituku	2. declaration of wishes on, one's death
loto	3. choice of one's actions, win
wind malohi	win
havili	1. movement of air
takai	2. turn in a circular way
faka’osi	3. wind up (finish)
takai	4. wind up (as a clock)
uinimila	windmill
matapā sio’ata	window
funga matapā sio’ata	window sill
havili	windy
kapakau	wing
faha’i ta’u momoko	winter
holoholo	wipe
uaea	wire
poto	wise
faka’amu	wish
mo	with
toho	withdraw (as for money), witness
woke *see wake fakamo’oni	witness
fefine	woman, wombat
won *see win uomipeti	wombat
fakakaukau	wonder
papa	wood
ngaohi’anga papa	woodwork
vavae	wool, word
wore *see wear fo’ilea	word
ngāue	1. labour
ngāue	2. carry out labour
ngāue	3. be operational
solova	4. work out (solve)
mamani	world
World Wide Web	World Wide Web
hoha’a	worry
kovi ange	worse
mahu’inga	worth
takai	wrap
tatau	wring
fasi ‘a nima	wrist
tohi	write
wrote *see write	X wrong (incorrect)
faka’ata	x-ray
‘iote	yacht
‘iate	yard
mamao	yawn
ta’u	year
engeenga	yellow
yes	int
‘aneafi	yesterday
koe	you
kei si’i	young
ho’o	your (possessive)
souni	zone
sū	zoo
sukini	zucchini
